1.010000000000000000e+02
4.800000000000000000e+01
8.600000000000000000e+01
1.660000000000000000e+02
8.700000000000000000e+01
1.700000000000000000e+01
1.820000000000000000e+02
3.500000000000000000e+01
2.000000000000000000e+02
7.900000000000000000e+01
2.000000000000000000e+01
8.500000000000000000e+01
1.010000000000000000e+02
2.000000000000000000e+02
1.300000000000000000e+01
1.040000000000000000e+02
7.300000000000000000e+01
1.400000000000000000e+02
6.200000000000000000e+01
1.130000000000000000e+02
1.300000000000000000e+01
4.500000000000000000e+01
1.100000000000000000e+01
2.300000000000000000e+01
1.590000000000000000e+02
1.300000000000000000e+01
1.300000000000000000e+01
1.300000000000000000e+01
1.000000000000000000e+01
1.000000000000000000e+01
1.000000000000000000e+01
2.200000000000000000e+01
1.600000000000000000e+01
3.500000000000000000e+01
1.300000000000000000e+01
1.300000000000000000e+01
1.700000000000000000e+01
6.900000000000000000e+01
1.500000000000000000e+01
1.200000000000000000e+01
4.800000000000000000e+01
1.400000000000000000e+01
1.400000000000000000e+01
1.500000000000000000e+01
1.000000000000000000e+01
7.400000000000000000e+01
1.400000000000000000e+01
4.700000000000000000e+01
1.400000000000000000e+01
1.100000000000000000e+01
7.300000000000000000e+01
7.300000000000000000e+01
4.500000000000000000e+01
4.200000000000000000e+01
1.500000000000000000e+01
3.100000000000000000e+01
1.000000000000000000e+01
1.400000000000000000e+01
3.100000000000000000e+01
3.800000000000000000e+01
6.500000000000000000e+01
1.360000000000000000e+02
7.900000000000000000e+01
1.000000000000000000e+01
1.100000000000000000e+01
1.400000000000000000e+01
3.900000000000000000e+01
1.300000000000000000e+01
1.300000000000000000e+01
2.200000000000000000e+01
3.600000000000000000e+01
1.300000000000000000e+01
1.400000000000000000e+01
1.000000000000000000e+01
1.400000000000000000e+01
1.200000000000000000e+01
2.000000000000000000e+01
1.600000000000000000e+01
1.500000000000000000e+01
1.900000000000000000e+01
1.100000000000000000e+01
1.500000000000000000e+01
1.800000000000000000e+01
2.400000000000000000e+01
1.100000000000000000e+01
1.600000000000000000e+01
1.600000000000000000e+01
1.200000000000000000e+01
1.000000000000000000e+01
1.500000000000000000e+01
1.300000000000000000e+01
1.600000000000000000e+01
1.500000000000000000e+01
1.900000000000000000e+01
1.500000000000000000e+01
1.500000000000000000e+01
1.700000000000000000e+01
1.200000000000000000e+01
1.600000000000000000e+01
1.200000000000000000e+01
